12
46
# . . . . . . . . . . . . . . . . . . . . . . . . . . . . . . . . . . . . . . . . . . . . #
# . . . . . . . . . . . . . . . . . . . . . . . . . . . . . . . . . . . . . . . . . . . . #
# . . . . . . . . . . . . . . . . . . . . . . . . . . . . . . . . . . . . . . . . . . . . #
# . . . . . . . . . . . . . . . . . . . . . . . . . . . . . . . . . . . . . . . . . . . . #
# . . . . . . . . . . . . . . . . . . . . . . . . . . . . . . . # # # . . . . . . # # # # #
# . . . . . . . . . . . . . . . . . . . . . . . . . . # # . . . . . . . . . . . . . . . . #
# . . . . . . . . . . . . . . . . . . . # # # # . . . . . . . . . . . . . . . . . . . . . #
# . . . . . . . . . . . . . . . . . . . . . . . . . . . . . . . . . . . . . . . . . . . . #
# . $ . . . . . # # # . . . # # . . . . . . . . . . . . . . . . . . . . . . # # # . . . . #
# . . . . . . . . . . . . . # # # # . . . . . . . . . . . . . # # # # # # # # # # . . . . #
# . . . . . . . . . . . . . # # # # . . . . . . . . . . . . . # # # # # # # # # # . . ^ . #
# # # # # # # # # # # # # # # # # # # # # # # # # # # . . . . # # # # # # # # # # # # # # #