12
36
#, ., ., ., ., ., ., ., ., ., ., ., ., ., ., ., ., ., ., ., ., ., ., ., ., ., ., ., ., ., ., ., ., ., ., #
#, ., ., ., ., ., ., ., ., ., ., ., ., ., ., ., ., ., ., ., ., ., ., ., ., ., ., ., ., ., ., ., ., ., ., #
#, ., ., ., ., ., ., ., ., ., ., ., ., ., ., ., ., ., ., ., ., ., ., ., ., ., ., ., ., ., ., ., ., ., ., #
#, ., ., ., ., ., ., ., ., ., ., ., ., ., ., ., ., ., ., ., ., ., ., ., ., ., ., ., ., ., ., ., ., ., ., #
#, ., ., ., ., ., ., ., ., ., ., ., ., ., ., ., ., ., ., ., ., ., ., ., ., ., ., ., ., ., ., ., #, #, #, #
#, ., ., ., ., ., ., ., ., ., ., ., ., ., ., ., ., ., ., ., ., ., ., ., ., ., ., #, #, ., ., ., ., ., ., #
#, ., ., ., ., ., ., ., ., ., ., ., ., ., ., ., ., ., ., ., #, #, #, #, ., ., ., ., ., ., ., ., ., ., ., #
#, ., ., ., ., ., ., ., ., ., ., ., ., ., ., ., ., ., ., ., ., ., ., ., ., ., ., ., ., ., ., ., ., ., ., #
#, ., $, ., ., ., ., ., #, #, #, ., ., ., #, #, ., ., ., ., ., ., ., ., ., ., ., ., ., ., ., ., ., ., ., #
#, ., ., ., ., ., ., ., ., ., ., ., ., ., #, #, #, #, ., ., ., ., ., ., ., ., ., ., ., ., ., ., ., ., ., #
#, ., ., ., ., ., ., ., ., ., ., ., ., ., #, #, #, #, ., ., ., ., ., ., ., ., ., ., ., ., ., ., ., ., ., #
#, #, #, #, #, #, #, #, #, #, #, #, #, #, #, #, #, #, #, #, #, #, #, #, #, #, #, #, #, #, #, #, #, #, #, #