20
46
} . . . . . . . . . . . . . . . . . . . . . . . . . . . . . . . . . . . . . . . . . . . . {
} . . . . . . . . . . . . . . . . . . . . . . . . . . . . . . . . . . . . . . . . . . . . {
} . . . . . . . . . . . . . . . . . . . . . . . . . . . . . . . . . . . . . . . . . . . . {
} . . . . . , . . . . . . , . . . . . . . , . . . . . . . . . . . . , . . . . . . : . . . {
} . . . . . . . . . . . . . . . . . . . . . . . . . . . . . . . . . . . . . . . . . . . . {
} . . . . : . . . . . . . . . . . . . . . . . . . , . . . . . . . . . . . . . . . . . . . {
} . . . . . . . . . # . . . . . . . . . . , . . . . . . . . . . . . . . . . . . . . . . . {
} . . . . . . . . . # . . . . . . . . . . . . . . : . . . . . . . . . . . . . . . . . . . {
} . . . . . . , . . # . . . . . . . . . . . . . . . . . . . . , . . . . . . . . . . . . . {
} . . . . . . . . . # . . . . . . . . . . . . . . . . . . . . . . . . . . . . . . . . . . {
} . . . . . . . . . . . . . . . . . . . . . . . . . . . . . . . . . . . . . . . . . . . . {
} . . . , . # : . . . . . # . . . . . . . . . . . . . . . . . . # # # . . . . . . # # # # {
} . . . . . # . . . . . . . . . . . . . . . . . . . . # # . . . . . . . . . . . . . . . . {
} . . . . . # . . . . . . . . . . . . . # # # # . . . . . . . . . . . . . . . . . . . . . {
} . . . . . . . . . . . . . . . . . . . . . . . . . . . . . . . . . . . . . . . . . . . . {
} . . . . . . . . . . . . . . . . . . . . . . . . . . . . . . . . . . . . . . . . . . . . {
} . . . . . . . # # # . . . # # . . . . . . . . . : . . . . . . . . . . . . # # # . . . . {
} . . . . . . . . . . . . . # # # # . . . . . . . . . . . . . # # # # # # # # # # . . . . {
} . . . . . . . . . . . . . # # # # . . . . . . . . . . . . . # # # # # # # # # # . . ^ . {
} # # # # # # # # # # # # # # # # # # # # # # # # # # . . . . # # # # # # # # # # # # # # {
