20
46
} . . . . . . . . . . . . . . . . . . . . . . . . . . . . . . . . . . . . . . . . . . . . {
} . . . . . . . . . . . . . . . . . . . . . . . . . . . . . . . . . . . . . . . . . . . . {
} . . . . . . . . . . . . . . . . . . . . . . . . . . . . . . . . . . . . . . . . . . . . {
} . . . . . , . . . . . . , . . . . . . . , . . . . . . . . . . . . , . . . . . . : . . . {
} . . . . . . . . . . . . . . . . . . . . . . . . . . . . . . . . . . . . . . . . . . . . {
} . . . . : . . . . . . . . . . . . . . . . . . . , . . . . . . . . . . . . . . . . . . . {
} . . . . . . . . . . . . . . . . . . . . , . . . . . . . . . . . . . . . . . . . . . . . {
} . . . . . . . . . . . . . . . . . . . . . . . . : . . . . . . . . . . . . . . . . . . . {
} . . . . . . , . . . . . . . . . . . . . . . . . . . . . . . , . . . . . . . . . . . . . {
} . . . . . . . . . . . . . . . . . . . . . . . . . . . . . . . . . . . . . . . . . . . . {
} . . . . . . . . . . . . . . . . . . . . . . . . . . . . . . . . . . . . . . . . . . . . {
} . . . , . . : . . . . . # . . . . . . . . . . . . . . . . . . # # # . . . . . . # # # # {
} . . . . . . . . . . . . . . . . . . . . . . . . . . # # . . . . . . . . . . . . . . . . {
} . . . . . . . . . . . . . . . . . . . # # # # . . . . . . . . . . . . . . . . . . . . . {
} . . . . . . . . . . . . . . . . . . . . . . . . . . . . . . . . . . . . . . . . . . . . {
} . . . . . . . . . . . . . . . . . . . . . . . . . . . . . . . . . . . . . . . . . . . . {
} . . . . . . . # # # . . . # # . . . . . . . . . : . . . . . . . . . . . . # # # . . . . {
} . . . . . . . . . . . . . # # # # . . . . . . . . . . . . . # # # # # # # # # # . . . . {
} . . . . . . . . . . . . . # # # # . . . . . . . . . . . . . # # # # # # # # # # . . ^ . {
} # # # # # # # # # # # # # # # # # # # # # # # # # # . . . . # # # # # # # # # # # # # # {